######################################
#@...................................#
#.################..################.#
#.#....#.....#...#..#...#.....#....#.#
#.#....#.....#...#..#...#.....#....#.#
#.#....#.....#...#..#...#.....#....#.#
#.############...#..#...#.....#....#.#
#.#....#.....#...#..#...############.#
#.#....#.....#...#..#...#.....#....#.#
#.#....#.....#####..#####.....#....#.#
#.#....#.....#..........#.....#....#.#
#.#....#.....#.########.#.....#....#.#
#.#....#.....#.#......#.#.....#....#.#
#.############.#......#.############.#
#..............#......#..............#
#.############.#......#.############.#
#.#....#..#..#.#......#.#.....#....#.#
#.#....#..#..#.########.#.....#....#.#
#.#....#..#..#..........#.....#....#.#
#.#....###########..#######...#....#.#
#.#....#.....#...#..#.....#...#....#.#
#.######.....#...#..#.....##########.#
#.#....#.....#...#..#.....#...#....#.#
#.#....#.....#...#..#.....#...#....#.#
#.#....#.....#...#..#.....#...#....#.#
#.#....#.....#...#..#.....#...#....#.#
#.################..################.#
#....................................#
######################################

#####################
#.........#.........#
#.....#########.....#
#.....#...@...#.....#
###.###.......###.###
#...................#
#####################